8 8
1M111111
10000001
11111101
10000001
10111111
10000001
11111101
111111E1