||||M||||||||
|0|00000000||
|0|0|||000|0|
|0|0|||0000||
|000000|000||
|0|0|0000|0||
|000000000|0|
|0|||||||||||
|00000000000|
|0|0000000|0|
|0|0|||000|0|
|0|0|||0000||
|000000|0000|
|||||0|||00||
|000000|0|0||
||||||||||E||
|||||||||||||
