17 16
1111111111111111
1000000M00000001
1111111011111111
1000000000000001
1111111011111111
1000000000000001
1111111011111111
1000000000000001
1111111011111111
1000000000000001
1111111011111111
1000000000000001
1111111011111111
100000000000000E
1111111011111111
1000000000000001
1111111111111111